TILEMAP
16 8
64 64
images/tilesBossLevel.png
8 8
7 6 6 6 6 6 6 6 6 6 6 6 6 6 6 7 
10 3 2 3 2 3 3 3 3 3 3 3 3 3 3 12 
21 3 3 3 3 3 3 3 3 3 3 4 3 3 3 17 
17 7 3 3 4 3 3 3 3 3 3 3 3 3 7 19 
18 1 8 7 8 7 7 7 7 7 7 8 7 8 1 19 
20 1 1 1 1 1 1 1 1 1 1 1 1 1 1 21 
18 13 23 1 13 22 22 22 22 22 22 23 1 13 23 19 
21 16 16 24 14 16 16 14 14 16 16 14 24 16 16 18