TILEMAP
100 8
64 64
images/tilesLevel1.png
8 8
12 10 10 12 11 10 11 11 11 10 10 10 12 10 10 10 10 12 12 12 10 10 12 12 12 12 10 10 10 10 11 11 11 10 10 10 10 12 12 12 12 11 10 10 10 10 10 10 10 10 10 10 10 12 10 10 11 10 12 11 10 10 10 10 27 27 27 27 27 27 27 27 27 27 27 27 27 27 27 27 27 35 35 35 35 27 27 27 27 27 27 27 27 27 27 27 27 27 27 27 
10 10 10 5 6 7 6 6 6 7 8 10 10 10 10 10 5 6 7 8 10 1 1 1 1 1 12 10 10 10 10 10 10 10 10 10 10 10 11 10 11 10 10 11 10 10 10 1 10 10 10 10 10 10 10 11 11 11 10 10 10 10 10 10 43 43 43 43 43 43 2 1 1 3 3 1 1 1 1 1 1 35 35 35 27 27 35 27 35 27 35 35 35 27 27 27 27 27 28 22 
10 10 10 13 14 15 14 14 14 15 16 1 1 1 1 10 13 14 15 16 1 9 9 9 9 9 1 10 5 7 6 10 10 10 1 1 10 10 10 10 10 10 10 10 10 10 1 1 1 18 19 19 19 19 19 19 19 19 19 19 19 20 1 1 51 51 1 1 1 1 1 9 1 1 1 9 9 1 1 9 9 1 51 43 43 43 43 43 43 35 35 27 27 27 27 35 27 28 29 30 
10 2 2 2 3 2 2 2 3 2 2 9 9 9 9 2 3 3 2 1 9 9 1 1 1 1 9 10 13 15 14 16 1 1 1 9 10 10 10 10 10 10 10 2 2 1 1 1 1 1 2 2 13 14 15 14 15 15 16 2 2 2 9 9 1 1 1 1 9 9 9 9 9 9 9 1 1 9 9 9 9 9 1 51 51 43 43 43 43 51 51 43 43 35 35 35 35 36 37 30 
10 1 1 1 1 1 1 1 1 1 1 1 1 1 9 1 1 1 1 1 1 1 1 1 1 1 1 10 1 1 2 2 9 9 1 1 10 1 10 1 10 1 10 1 1 1 1 1 1 1 1 1 18 19 19 19 19 19 20 1 1 1 1 1 9 9 1 1 1 1 1 1 1 1 1 1 1 1 1 1 1 1 1 1 1 43 1 1 43 1 1 51 43 43 43 43 43 44 45 38 
25 9 9 9 9 9 1 1 9 9 9 9 9 9 1 1 1 1 1 1 1 1 1 1 1 9 9 25 9 1 1 1 9 9 9 9 25 9 25 9 25 9 25 9 9 9 9 9 9 9 9 9 25 25 25 25 25 25 25 9 9 9 9 9 9 9 9 9 9 9 9 9 9 1 1 9 1 1 9 9 9 9 9 9 9 25 9 9 25 9 9 1 51 43 43 43 43 52 53 46 
25 17 17 17 17 17 17 17 58 9 9 9 9 58 17 17 17 17 58 58 58 58 17 17 17 17 17 25 58 9 9 9 9 9 9 9 25 17 25 17 25 17 25 17 17 17 17 17 17 17 17 17 25 25 25 25 25 25 25 17 17 17 17 17 17 17 17 17 17 17 17 17 17 17 41 1 9 9 9 9 9 9 9 9 9 25 17 17 25 58 58 58 58 51 51 51 51 60 61 54 
25 25 25 25 25 25 25 25 25 58 58 58 58 25 25 25 25 33 34 25 25 25 25 25 25 25 33 34 25 49 49 49 49 49 49 49 25 25 25 25 25 25 25 25 25 25 33 34 25 25 25 25 25 25 25 25 25 25 25 25 25 33 34 25 25 25 25 25 25 33 34 25 25 25 25 49 49 49 49 49 49 49 49 49 57 34 25 25 25 25 25 25 25 1 1 1 1 1 1 54
