TILEMAP
100 8
64 64
images/tilesLevel1.png
8 8
11 9 9 11 10 9 10 10 10 9 9 9 11 9 9 9 9 11 11 11 9 9 11 11 11 11 9 9 9 9 10 10 10 9 9 9 9 11 11 11 11 10 9 9 9 9 9 9 9 9 9 9 9 11 9 9 10 9 11 10 9 9 9 9 26 26 26 26 26 26 26 26 26 26 26 26 26 26 26 26 26 34 34 34 34 26 26 26 26 26 26 26 26 26 26 26 26 26 26 26
9 9 9 4 5 6 5 5 5 6 7 9 9 9 9 9 4 5 6 7 9 0 0 0 0 0 11 9 9 9 9 9 9 9 9 9 9 9 10 9 10 9 9 10 9 9 9 0 9 9 9 9 9 9 9 10 10 10 9 9 9 9 9 9 9 9 9 9 9 9 1 0 0 2 2 0 0 0 0 0 0 34 34 34 26 26 34 26 34 26 34 34 34 26 26 26 26 26 27 21
9 9 9 12 13 14 13 13 13 14 15 0 0 0 0 9 12 13 14 15 0 8 8 8 8 8 0 9 4 6 5 9 9 9 0 0 9 9 9 9 9 9 9 9 9 9 0 0 0 17 18 18 18 18 18 18 18 18 18 18 18 19 0 0 9 9 0 0 0 0 0 8 0 0 0 8 8 0 0 8 8 0 50 42 42 42 42 42 42 34 34 26 26 26 26 34 26 27 28 29
9 1 1 1 2 1 1 1 2 1 1 8 8 8 8 1 2 2 1 0 8 8 0 0 0 0 8 9 12 14 13 15 0 0 0 8 9 9 9 9 9 9 9 1 1 0 0 0 0 0 1 1 12 13 14 13 14 14 15 1 1 1 8 8 0 0 0 0 8 8 8 8 8 8 8 0 0 8 8 8 8 8 0 50 50 42 42 42 42 50 50 42 42 34 34 34 34 35 36 29
9 0 0 0 0 0 0 0 0 0 0 0 0 0 8 0 0 0 0 0 0 0 0 0 0 0 0 9 0 0 1 1 8 8 0 0 9 0 9 0 9 0 9 0 0 0 0 0 0 0 0 0 17 18 18 18 18 18 19 0 0 0 0 0 8 8 0 0 0 0 0 0 0 0 0 0 0 0 0 0 0 0 0 0 0 42 0 0 42 0 0 50 42 42 42 42 42 43 44 37
24 8 8 8 8 8 0 0 8 8 8 8 8 8 0 0 0 0 0 0 0 0 0 0 0 8 8 24 8 0 0 0 8 8 8 8 24 8 24 8 24 8 24 8 8 8 8 8 8 8 8 8 24 24 24 24 24 24 24 8 8 8 8 8 8 8 8 8 8 8 8 8 8 0 0 8 0 0 8 8 8 8 8 8 8 24 8 8 24 8 8 0 50 42 42 42 42 51 52 45
24 16 16 16 16 16 16 16 57 8 8 8 8 57 16 16 16 16 57 57 57 57 16 16 16 16 16 24 57 8 8 8 8 8 8 8 24 16 24 16 24 16 24 16 16 16 16 16 16 16 16 16 24 24 24 24 24 24 24 16 16 16 16 16 16 16 16 16 16 16 16 16 16 16 40 0 8 8 8 8 8 8 8 8 8 24 16 16 24 57 57 57 57 50 50 50 50 59 60 53
24 24 24 24 24 24 24 24 24 57 57 57 57 24 24 24 24 32 33 24 24 24 24 24 24 24 32 33 24 48 48 48 48 48 48 48 24 24 24 24 24 24 24 24 24 24 32 33 24 24 24 24 24 24 24 24 24 24 24 24 24 32 33 24 24 24 24 24 24 32 33 24 24 24 24 48 48 48 48 48 48 48 48 48 56 33 24 24 24 24 24 24 24 0 0 0 0 0 0 53


